1111111111111111111
111111P011111111111
1111111C11111111111
1000C01000C0000C001
1000000000000000001
1C0000C00000C000001
1000C11111100000001
111111111111101C111
1111111C11111E11111
1111111111111111111