11111111111111111
110111P0111010111
1101110C111001111
1000C00000C0000C1
10000000000000001
1C0000C00000C0001
1000C111111000E01
11111111111111111
